1111111111111111111
1000001000000000001
1110101101111010101
1000100000000010001
1110111101101010111
1000100000001010101
1010101110101000101
1000000000000010001
1010101011101011101
1010101000000000101
1010101110111010101
1000100000000000101
1110101011101010101
1000001000001000001
1111111111111111111
