1111111111111111111
1000000000000000001
1011101110111011101
1011101110111011101
1011101110111011101
1000000000000000001
1011101110111011101
1011101110111011101
1011101110111011101
1000000000000000001
1011101110111011101
1011101110111011101
1011101110111011101
1000000000000000001
1111111111111111111
