1111111111111111111
1010001110000010001
1001101110101010101
1101100000001010001
1101111011101010101
1100001000000000101
1011101110111011101
1000100010000000001
1110111011111011111
1010001010001011111
1011111011111011101
1000001000001001101
1011011111101101101
1011000000100000001
1111111111111111111
